"filename", "language", "Python", "HTML", "comment", "blank", "total"
"c:\Users\ARJIT\OneDrive\Documents\django projects\E_commerce_website\atlasonline\shop\templates\shop\appliances.html", "HTML", 0, 50, 0, 18, 68
"c:\Users\ARJIT\OneDrive\Documents\django projects\E_commerce_website\atlasonline\shop\templates\shop\basic.html", "HTML", 0, 19, 0, 6, 25
"c:\Users\ARJIT\OneDrive\Documents\django projects\E_commerce_website\atlasonline\shop\templates\shop\beauty.html", "HTML", 0, 50, 0, 18, 68
"c:\Users\ARJIT\OneDrive\Documents\django projects\E_commerce_website\atlasonline\shop\templates\shop\beverages.html", "HTML", 0, 50, 0, 18, 68
"c:\Users\ARJIT\OneDrive\Documents\django projects\E_commerce_website\atlasonline\shop\templates\shop\cleaning.html", "HTML", 0, 50, 0, 18, 68
"c:\Users\ARJIT\OneDrive\Documents\django projects\E_commerce_website\atlasonline\shop\templates\shop\clothes.html", "HTML", 0, 50, 0, 18, 68
"c:\Users\ARJIT\OneDrive\Documents\django projects\E_commerce_website\atlasonline\shop\templates\shop\daily_items.html", "HTML", 0, 50, 0, 18, 68
"c:\Users\ARJIT\OneDrive\Documents\django projects\E_commerce_website\atlasonline\shop\templates\shop\electronics.html", "HTML", 0, 50, 0, 18, 68
"c:\Users\ARJIT\OneDrive\Documents\django projects\E_commerce_website\atlasonline\shop\templates\shop\food.html", "HTML", 0, 50, 0, 17, 67
"c:\Users\ARJIT\OneDrive\Documents\django projects\E_commerce_website\atlasonline\shop\templates\shop\furniture.html", "HTML", 0, 50, 0, 18, 68
"c:\Users\ARJIT\OneDrive\Documents\django projects\E_commerce_website\atlasonline\shop\templates\shop\health.html", "HTML", 0, 50, 0, 18, 68
"c:\Users\ARJIT\OneDrive\Documents\django projects\E_commerce_website\atlasonline\shop\templates\shop\index.html", "HTML", 0, 20, 0, 2, 22
"c:\Users\ARJIT\OneDrive\Documents\django projects\E_commerce_website\atlasonline\shop\templates\shop\medical.html", "HTML", 0, 50, 0, 18, 68
"c:\Users\ARJIT\OneDrive\Documents\django projects\E_commerce_website\atlasonline\shop\templates\shop\office.html", "HTML", 0, 50, 0, 18, 68
"c:\Users\ARJIT\OneDrive\Documents\django projects\E_commerce_website\atlasonline\shop\templates\shop\sports_equipment.html", "HTML", 0, 50, 0, 18, 68
"c:\Users\ARJIT\OneDrive\Documents\django projects\E_commerce_website\atlasonline\shop\views.py", "Python", 28, 0, 0, 1, 29
"Total", "-", 28, 689, 0, 242, 959