"filename", "language", "Python", "HTML", "comment", "blank", "total"
"c:\Users\ARJIT\OneDrive\Documents\django projects\E_commerce_website\atlasonline\shop\templates\shop\appliances.html", "HTML", 0, 29, 0, 1, 30
"c:\Users\ARJIT\OneDrive\Documents\django projects\E_commerce_website\atlasonline\shop\templates\shop\basic.html", "HTML", 0, 58, 2, 3, 63
"c:\Users\ARJIT\OneDrive\Documents\django projects\E_commerce_website\atlasonline\shop\templates\shop\beauty.html", "HTML", 0, 29, 0, 3, 32
"c:\Users\ARJIT\OneDrive\Documents\django projects\E_commerce_website\atlasonline\shop\templates\shop\beverages.html", "HTML", 0, 29, 0, 1, 30
"c:\Users\ARJIT\OneDrive\Documents\django projects\E_commerce_website\atlasonline\shop\templates\shop\cleaning.html", "HTML", 0, 29, 0, 1, 30
"c:\Users\ARJIT\OneDrive\Documents\django projects\E_commerce_website\atlasonline\shop\templates\shop\clothes.html", "HTML", 0, 29, 0, 5, 34
"c:\Users\ARJIT\OneDrive\Documents\django projects\E_commerce_website\atlasonline\shop\templates\shop\daily_items.html", "HTML", 0, 29, 0, 1, 30
"c:\Users\ARJIT\OneDrive\Documents\django projects\E_commerce_website\atlasonline\shop\templates\shop\electronics.html", "HTML", 0, 29, 0, 2, 31
"c:\Users\ARJIT\OneDrive\Documents\django projects\E_commerce_website\atlasonline\shop\templates\shop\food.html", "HTML", 0, 29, 0, 3, 32
"c:\Users\ARJIT\OneDrive\Documents\django projects\E_commerce_website\atlasonline\shop\templates\shop\furniture.html", "HTML", 0, 29, 0, 3, 32
"c:\Users\ARJIT\OneDrive\Documents\django projects\E_commerce_website\atlasonline\shop\templates\shop\health.html", "HTML", 0, 29, 0, 1, 30
"c:\Users\ARJIT\OneDrive\Documents\django projects\E_commerce_website\atlasonline\shop\templates\shop\index.html", "HTML", 0, 41, 2, 1, 44
"c:\Users\ARJIT\OneDrive\Documents\django projects\E_commerce_website\atlasonline\shop\templates\shop\medical.html", "HTML", 0, 29, 0, 1, 30
"c:\Users\ARJIT\OneDrive\Documents\django projects\E_commerce_website\atlasonline\shop\templates\shop\office.html", "HTML", 0, 29, 0, 1, 30
"c:\Users\ARJIT\OneDrive\Documents\django projects\E_commerce_website\atlasonline\shop\templates\shop\sports_equipment.html", "HTML", 0, 29, 0, 1, 30
"c:\Users\ARJIT\OneDrive\Documents\django projects\E_commerce_website\atlasonline\shop\urls.py", "Python", 1, 0, 0, 0, 1
"c:\Users\ARJIT\OneDrive\Documents\django projects\E_commerce_website\atlasonline\shop\views.py", "Python", 14, 0, 0, 1, 15
"Total", "-", 15, 476, 4, 29, 524